111111111
1000CE001
1C00000X1
100000P01
100C00001
10X0000C1
111111111
