1111111111111111111111111111111111
101000000000000C00000C000000000001
1000010100100000101001000000010101
1010010010101010001001000000010101
1P0000000C00C000000000000X000000C1
10000X00000000000000C0000000000001
1000000000000000000000000000000001
10000000C00000000E0000000000000001
1000000000001110000000000000000011
111111100000000000000000001C000001
11100000000X0000000000000000000101
110000000111000000000000CX00000001
1000000000000000000000000000000001
1111111111111111111111111111111111
