1111111
1000001
10C0011
10C1011

1000011
111P0E1
1111111
1111111
